................
...3.........3..
....3.......3...
....333333333...
...33333333333..
..33..33333..33.
.333..33333..333
.3.33333333333.3
.3.33333333333.3
33.33.......33.3
3..3.........3..
....333...333...