................
2222222222222222
2222222222222222
2222222222222222
2222222..2222222
222222....222222
222222....222222
22222......22222
2222........2222
222..........222
22............22
2..............2