................
...3.........3..
....3.......3...
...U333333333U..
..U33333333333U.
.U33UU33333UU33U
U333UU33333UU333
U3.33333333333.3
U3.33333333333.3
33.33U.....U33.3
3..3U.......U3..
....333...333...
................
.U............U.
....U......U....
U..............U