................
UU2222UUU22222UU
U22222222222222U
2222222222222222
2222222222222222
222222U.U2222222
222222...2222222
22222U...U222222
22222......22222
222U........U222
U2............2U
UU............UU