................
................
1111111111111111
1111111111111111
1111111111111111
U11111111111111U
UU111111111111UU
UUU1111111111UUU